10 22
#****------------***$**--*
*---*-------*******---****
*---***----*******-------*
******--**---***----**--**
*----****-***--*---***-*-*
**-----****---**----******
-*************************
*********--------********-
*****------*******------**
----*********************-
