15 20
*********#**********
********************
********************
*****---------******
********************
********************
-----*********------
-----*********------
****-----------*****
********************
----------**********
---------********---
--********---*******
---*************----
$****---------*****-
