9 21
-----#---------------
-----*---------------
-*****---------------
-----*-*********--*--
-----*--*-*----*--*--
-----*--*-*----*--*--
-----*-**------*-----
-----***-----***-----
-----**$-------------